BWWBBBBBBBBBBBBBBBBBBBBBBBBBBBBBBBBBBBBBBBBBBBBBBBBBBBBBBBBBBBBBBBBBBBBBBBBBBBBB
BWWWWWWWWWWWWWWWWWWWWWWWWBWWWWWWWWWBWWWWWBWWWWWBBWWWWWBWWWWWWWWBBWWWWWWWWWWWWWWB
BWWWWWWWWWWWWWWWWWWWWWWWWBWWWWWWWWWBWWWWWBWWWWWBBWWWWWBWWWWWWWWBBWWWWWWWWWWWWWWB
BWWBBBBBBBBBBBBBBBBWWWBBBBWWWBBBBWWBWWBWWBWWBWWBBWWBWWBWWBBBBWWBBWBBBBBBBBWWWBBB
BWWBWWWWWWWWWWWWWWBWWWWWWBWWWBWWWWWBWWBWWBWWBWWBBWWBWWBWWBWWWWWBBWWWWWWWWBWWWWWB
BWWBWWWWWWWWWWWWWWBWWWWWWBWWWBWWWWWBWWBWWBWWBWWBBWWBWWBWWBWWWWWBBWWWWWWWWBWWWWWB
BWWBWWWBWWBBBBBBBWBBBBWWWBWWWBWWBBBBWWBWWBWWBWWBBWWBWWBWWBWWWBWBBBBBBBWWWBBBBWWB
BWWBWWWBWWWWWWWBBWWWWBWWWWWWWBWWWWWBWWBWWBWWBWWBBWWBWWBWWBWWWBWWWWWWWBWWWWWWBWWB
BWWBWWWBWWWWWWWBBWWWWBWWWWWWWBWWWWWBWWBWWBWWBWWBBWWBWWBWWBWWWBWWWWWWWBWWWWWWBWWB
BWWBWWWBBBBBBBWBBWWWWBBBBBBBBBBBBWWBWWBWWBWWBWWBBWWBWWBWWBWWWBBBBBBBBBBBBBWWBWWB
BWWBWWWWWWBWWWWBBBBBWBWWWWWWWWWWBWWWWWBWWBWWBWWBBWWBWWBWWBWWWWWWWWWWWWWWWBWWBWWB
BWWBWWWWWWBWWWWBBWWWWBWWWWWWWWWWBWWWWWBWWBWWBWWBBWWBWWBWWBWWWWWWWWWWWWWWWBWWBWWB
BWWBWWWWWBBWWWWBBWWWWBBWWWWWWWWWBBWWWWBWWBWWBWWBBWWBWWBWWBWWWWWWWWWWWWWWWBWWBWWB
BWWBWWWBBBBWWBBBBWWBBBBBBBBBBWWWBBBBBBBWWBWWBWWWWWWBWWBWWBBBBBBBBBBWWBWWWBWWBWWB
BWWBWWWBWWWWWBWWBWWWWWWWWWWWWWWWWWWWWWBWWBWWBWWWWWWBWWBWWBWWWWWWWWWWWBWWWBWWBWWB
BWWBBBBBWWBBBBWWBBBBBBBBBBBBBBBBBBBBWWBWWBWWBBBBBBBBWWBWWBWWWBBBBBBBBBWWWBWWBWWB
BWWBBBBBWWBBBBWWBBBBBBBBBBBBBBBBBBBBWWBWWBWWBBBBBBBBWWBWWBWWWBBBBBBBBBWWWBWWBWWB
BWWBWWWWWWBWWWWWWWWWWWWWWWWWWBWWWWWBWWBWWWWWBWWWWWWWWWBWWBWWWWWWWWBWWWWWWBWWBWWB
BWWBWWWBBBBWWWWWWWWWWWWWWWWWWBWWWWWBWWBBBBBBBWWWWWWWWWBWWBBBBBBBWWBWWWWWWBWWBWWB
BWWWWWWBWWWWWBBBBBBBBBBBBBBWWBWBBWWBWWWWWWWBBWWBBBBBBBBWWWWWWWWBBWBBBBBBBBWWBWWB
BWWWWWWBWWWWWBWWWWWWWWWWWWBWWBWBBWWBWWWWWWWWBWWWWWWWWWBWWWWWWWWBBWWWWWWWWBWWBWWB
BWWWWWWBWWWWWBWWWWWWWWWWWWBWWBWBBWWBBBBBBBWWBWWWWWWWWWBBBBBBBWWBBWWWWWWWWBWWBWWB
BBBBBBBBWWBBBBBBBWBWWWBBBBBWWBWBBWWWWWWWWBWWBBBBBBBWWWWWWWWWWWWBBBBBBBBWWWWWBWWB
BWWWWWWBWWWWWWWWWWBWWWBWWWWWWBWBBWWWWWWWWBWWWWWWWWBWWWWWWWWWWWWBBWWWWBBWWWWWBWWB
BWWWWWWBWWWWWWWWWWBWWWBWWWWWWBWBBWWWWWWWWBWWWWWWWWBWWWWWWWWWWWWBBWWWWBBWWWWWBWWB
BWWWWWWBBBBBBBBBBBBWWWBWWWBBBBWBBWWWWWBBBBBBBBBBBWBBWWWWWWWWWWWBBWWWWBBBBBBBBWWB
BWWBWWWWWWWWWWWWWWWWWWBWWWWWWBWWBBBWWWWWWWWWWWWBBWBBBBBBBBBBBBBBBBBWWWWWWBWWBWWB
BWWBWWWWWWWWWWWWWWWWWWBWWWWWWBWWWWBWWWWWWWWWWWWBBWWWWWWWWWWWWWWWWWWWWWWWWBWWBWWB
BWWBBWWWWWWWWWWWWWWWWWBWWWWWWBWWWWBBWWWWWWWWWWBBBWWWWWWWWWWWWWWWWWWWWWWWWBWWBWWB
BWWBBBBBBBBBBBBBBBBBBBBBBBWWWBBBBWBBBBBWWBBBBBBBBBBBBBBBBBBBBBBBBBBBBBWWWWWWBWWB
BWWBWWWWWWWWWWWWWWWWWWWWWBWWWWWBBWWWWWBWWWWWWWWWWWWWWWWWWWWWWWWWWWWWWWWWWWWWBWWB
BWWBWWWWWWWWWWWWWWWWWWWWWBBBBWWBBBBBWWBWWWWWWWWWWWWWWWWWWWWWWWWWWWWWWWWWWWWWBWWB
BWWBWWWBBBBBBBBBBBBBBBWWWBBBBBWWBBBBWWBBBBBBBBBBBBBBBBBBBBBBBBBBBBBBBBBBBBBBBWWB
BWWBWWWBWWWWWWWWWWWWWWWWWBWWWBWWWWWBWWWWWWWWWWWWWWWWWWBWWWWWWWWWWWWWWWBWWWWWBWWB
BWWBWWWBWWWWWWWWWWWWWWWWWBWWWBBBBWWBWWWWWWWWWWWWWWWWWWBWWWWWWWWWWWWWWWBWWWWWBWWB
BWWBWWWBWWBBBBBBBBBBBBBBBBWWWWWWBWWBBBBBBBBBBBBBBBBBWWWWWBBBBBBBBBBBBBBWWBWWWWWB
BWWBWWWBWWWWWWWWWWWWWWWWWWWWWWWWBWWBWWWWWWWWWWWWWWWBWWWWWBWWWWWWWWWWWWWWWBWWWWWB
BWWBWWWBWWWWWWWWWWWWWWWWWWWWWWWWBWWBWWWWWWWWWWWWWWWBWWWWWBWWWWWWWWWWWWWWWBWWWWWB
BWWBWWWBBBBBBBBBBBBBBBBBBBBBBWWWBWWBWWWBBBBBBBBBBWWBBBWWWBWWWBBBBBBBBBBBBBBBBBBB
BWWBWWWBWWWWWWWWBWWWWWWWWWWWWWWWBWWBWWWWWWWWBWWBBWWWWBWWWBWWWWWWWWWWWWWWWWWWWWWB
BWWBWWWBWWWWWWWWBWWWWWWWWWWWWWWWBWWBWWWWWWWWBWWBBWWWWBWWWBWWWWWWWWWWWWWWWWWWWWWB
BWWBWWWBWWBBBBWWBWWBBBBBBBBBBBBBBWWBBBBBBBWWBWWBBBBWWBWWWBBBBBBBBBBBBBBBBBBBBWWB
BWWBWWWBWWBWWBWWBWWWWWWWWWWWWWWWBWWBWWWWWBWWWWWBBWBWWBWWWBWWWWWWWWWWWWWWWWWWWWWB
BWWBWWWBWWBWWBWWBWWWWWWWWWWWWWWWBWWBWWWWWBWWWWWBBWBWWBWWWBWWWWWWWWWWWWWWWWWWWWWB
BWWBWWWBWWBWWBWWBBWWWWWWWWWWBBBBBWWBWWWWWBWWWWWBBWBWWBWWWBWWWBBBBBBBBBBBBBBBBBBB
BWWBWWWBWWBWWBWWBBBBBBBBBBWWBWWWWWWBWWBWWBBBBBWWWWBWWBWWWBWWWWWWWWWWWWWWWWWWWWWB
BWWBWWWBWWBWWBWWWWWWWWWWWWWWBWWWWWWBWWBWWWWWWBWWWWBWWBWWWBWWWWWWWWWWWWWWWWWWWWWB
BWWBWWWBWWBWWBBBBBBBBBBBBBBBBWWBBBBBWWBBBBWWWBWWBBBWWBWWWBBBBBBBBBBBBBBBBBBBBWWB
BWWWWWWBWWBWWBBBBBBBBBBBBBBBBWWBBBBBWWWWWBWWWBWBBBBWWBWWWBWWWWWWWWBWWWWWWWWWWWWB
BWWWWWWBWWBWWWWBBWWBWWWWWWWWBWWWWWWBWWWWWBWWWBWBBWWWWBWWWBWWWWWWWWBWWWWWWWWWWWWB
BBBBBBBBWWBWWWWBBWWBWWWWWWWWBWWWWWWBBBBWWBWWWBWBBWWBBBWWWBWWBBBBWWBWWWBBBBBBBBBB
BBWWWWBBWWWWWBWBBWWWWWBBBBWWBBBBBWWWWWWWWBWWWBWBBWWWWBWWWWWWBWWBBWBWWWWWWWWWWWBB
BWWWWWWBWWWWWBWBBWWWWWBWWBWWWWWBBWWWWWWWWBWWWBWBBWWWWBWWWWWWBWWBBWBWWWWWWWWWWWWB
BWWBBBBBBBBBBBWBBWWWWWBWWBWWWWWBBWWWWWWWWBWWWBWBBBBWWBWWWWWWBWWBBWBWWWWWWWWWWWWB
BWWWWWWWWWWWBBWBBBBBWWBWWBBBBWWBBBBBBBBBBBWWWBWBBWBWWBBBBBBBBWWWWWBBBBBBBBBBBWWB
BWWWWWWWWWWWWBWWWWWBWWBWWBWWWWWWWWWWWWBWWWWWWBWBBWBWWWWWWWWWWWWWWWBWWWWWWWWWWWWB
BWWWWWWWWWWWWBWWWWWBWWBWWBWWWWWWWWWWWWBWWWWWWBWBBWBWWWWWWWWWWWWWWWBWWWWWWWWWWWWB
BWWBBBBBBBBWWBWWWWWBWWBWWBWWWWWWWWWWWWBWWWWWWBWBBWBBBBBBBBBBBBBBBBBWWWBBBBBBBBBB
BWWWWWWWWWBWWBBBBWWBWWWWWBWWWBBBBBBWWWBWWBWWWBWBBWWWWWWWWWWWWWWWWWBWWWWWWWWWWWWB
BWWWWWWWWWBWWWWWBWWBWWWWWBWWWBWWWWWWWWBWWBWWWBWBBWWWWWWWWWWWWWWWWWBBWWWWWWWWWWWB
BBWWWWWWWWBWWWWWBWWBBBBBBBWWWBWWWWWWWWBWWBWWWBWBBWWWWWWWWWWWWBBBBBBBBBBBBBBBBWWB
BBBBBBBBWWBBBBWWBWWWWWWWWWWWWBWWBBBBBBBWWBWWWBWWWWWBBBBBBBBWWBWWWWWWWWWWWWWWWWWB
BWWWWWWBWWWWWBWWBWWWWWWWWWWWBBWWBWWWWWBWWBWWBBWWWWWBWWWWWWBWWBWWWWWWWWWWWWWWWWWB
BWWBBBBBBBWWWBWWBBBBBBBBBBBBBBWWBWWBWWBWWBBBBBBBBBBBWWBWWWBWWBWBBBBBBBBBBBBBBBBB
BWWBBBBBBBWWWBWWWWWWWWWWWWWWWBWWWWWBWWBWWBWWWWWWWWWBWWBWWWBWWBWWWWWWWWWWWWWWWWWB
BWWWWWWBWWWWWBWWWWWWWWWWWWWWWBWWWWWBWWBWWBWWWWWWWWWBWWBWWWBWWBWWWWWWWWWWWWWWWWWB
BBBWWWWBWWBBBBBBBBBBBBBWWWBBBBBBBBBBWWBWWBWWWBBBBWWBWWBWWWBWWBBBBBBBBBBBBBBBBWWB
BBWWWWWBWWBWWWWWWWWWWWBWWWWWBBWWWWWBWWBWWBWWWBWWWWWBWWBWWWBWWWWBBWBWWWWWWWWWWWWB
BWWWWWWBWWBWWWWWWWWWWWBWWWWWWBWWWWWBWWBWWBWWWBWWWWWBWWBWWWBWWWWBBWBWWWWWWWWWWWWB
BWWBBBBBWWBWWWWWBBBBWWBBBBBWWBWWWWWBWWBWWBWWWBWWBBBBWWBWWWBBBBWBBWBWWWBBBBBBBBBB
BWWWWWWBWWBWWBWWBWWBWWWWWBBWWBWBBWWBWWBWWWWWWBWWWWWBWWBWWWWWBBWBBWBWWWWWWWWWWWWB
BWWWWWWBWWBWWBWWBWWWWWWWWWBWWBWBBWWBWWBWWWWWWBWWWWWBWWBWWWWWWBWBBWBWWWWWWWWWWWWB
BWWWWWWBWWBWWBWWBWWWWWWWWWBWWBWBBWWBWWBBBBBBBBBBWWWBWWBBBBBWWBWBBWBBBBBBBBBBBWWB
BBBWWWWBWWBBBBWWBBBBBBBBBBBWWBWBBWWBWWBWWWWWWWWWWWWBWWWWWWBWWBWBBWWWWBWWWWWWWWWB
BWWWWWWBWWWWWBWWBWWWWWWWWWWWWBWBBWWBWWBWWWWWWWWWWWWBWWWWWWBWWBWBBWWWWBWWWWWWWWWB
BWWWWWWBWWWWWBWWBWWWWWWWWWWWWBWBBWWBWWBWWWWWWWWWWWWBWWWWWWBWWBWBBWWWWBWWWWWWWWWB
BWWBBBBBBBWWWBWWBWWWWWWWWWWWBBWBBWWBWWBWWBBBBBBBBBBBBBWWWWBWWBWBBWWWWBWWWBBBBBBB
BWWWWWWWWWWWWWWWBWWBBBBBBBBBBBWBBWWWWWBWWWWWWWWWWWWWWWWWWWBWWWWWWWBWWBWWWWWWWWWB
BWWWWWWWWWWWWWWWBWWWWWWWWWWWWWWBBWWWWWBWWWWWWWWWWWWWWWWWWWBWWWWWWWBBWBWWWWWWWWWB
BBBBBBBBBBBBBBBBBBBBBBBBBBBBBBBBBBBBBBBBBBBBBBBBBBBBBBBBBBBBBBBBBBBBBBBBBBBBBWWB
