BBWWWBBBBBBBBBBBBBBBBBBBBBBBBBBBBBBBBBBBBBBBBBBBBBBBBBBBBBBBBBBBBBBBBBBBBBBBBBBBBBBBBBBBBBBBBBBBBBBBBBBBBBBBBBBBBBBBBBBBBBBBBBBBBBBBBBBBBBBBBB
BBWWWBBBBBBBBBBBBBBBBBBBBBBBBBBBBBBBBBBBBBBBBBBBBBBBBBBBBBBBBBBBBBBBBBBBBBBBBBBBBBBBBBBBBBBBBBBBBBBBBBBBBBBBBBBBBBBBBBBBBBBBBBBBBBBBBBBBBBBBBB
BBWWWWWWWBBWWWWWWWWWWWWBWWWBBWWWWWWWBBWWWBWWWWWWWWWWWWWWWWWWWWWWWWWWWWWWBBWWWWWWWWWWWWBBWWWWWWWWWWWWWWWWWWWWWWWWWBWWWWWWWWWWWWWBWWWWWWWWWWWWBB
BBWWWWWWWWBWWWWWWWWWWWWBWWWWBWWWWWWWBBWWWBWWWWWWWWWWWWWWWWWWWWWWWWWWWWWWBBWWWWWWWWWWWWBBWWWWWWWWWWWWWWWWWWWWWWWWWBWWWWWWWWWWWWWBWWWWWWWWWWWWBB
BBWWWWWWWBBWWWWWWWWWWWWBWWWWBWWWWWWWBBWWWBWWWWWWWWWWWWWWWWWWWWWWWWWWWWWWBBWWWWWWWWWWWWBBWWWWWWWWWWWWWWWWWWWWWWWWWBWWWWWWWWWWWWBBWWWWWWWWWWWWBB
BBWWWBBBBBBWWWBWWWBBWWWBWWWWBWWWBWWWBBWWWBWWWWBBBBBBBBBBBBBBWWWWBWWWBBBBBBWWWBWWWWBWWWBBBBBBBBBBBBBBBBBBBBBBBBWWWBWWWWBWWWBBBBBBWWWBBBBBBWWWBB
BBWWWWWWWWWWWWBWWWBBWWWBWWWWWWWWBWWWBBWWWWWWWWBBWWBBWWWWWWBBWWWWBWWWBBWWWWWWWBWWWWBWWWBBWWWWWWWWWWWWWWWWWWWWWWWWWBWWWWBWWWBBWWWWWWWWWWWBBWWWBB
BBWWWWWWWWWWWWBWWWBBWWWBWWWWWWWWBWWWBBWWWWWWWWBWWWBBWWWWWWWBWWWWBWWWBBWWWWWWWBWWWWBWWWBBWWWWWWWWWWWWWWWWWWWWWWWWWBWWWWBWWWBBWWWWWWWWWWWWBWWWBB
BBWWWWWWWWWWWWBWWWBBWWWBWWWWWWWWBWWWBBWWWWWWWWBWWWBBWWWWWWWBWWWWBWWWBBWWWWWWWBBWWBBWWWBBWWWWWWWWWWWWWWWWWWWWWWWWWBWWWWBWWWBBWWWWWWWWWWWWBWWWBB
BBWWWWWWWWWWWBBBWWBBWWWBBWWWWWWWBWWWBBWWWWWWWBBWWWBBWWWWWWWBWWWWBBWBBBWWWWWWBBBBBBBWWWBBWWWWWWWWWWWWWWWWWWWWWWWWWBWWWWBBWBBBWWWWWWWWWWWWBWWWBB
BBWWWBBBBBBBBBBBBBBBWWWBBBBBBWWWBWWWBBWWWBBBBBBWWWBBWWBBWWWBWWWWBBBBBBWWBBBBBBBBBBBWWWBBWWWBBBBBBBBBBBBBBBBBBBWWWBWWWWBBBBBBWWWBBBBBWWWWBWWWBB
BBWWWBBWWWWWWWBWWWWWWWWBBWWWWWWWBWWWBBWWWWWWWWWWWWBBWWBBWWWWWWWWBWWWWWWWBBWWWWWWWBBWWWBBWWWWWWWBBWWWWWWWBBWWWWWWWWWWWWBWWWWWWWWBBWWBWWWWBWWWBB
BBWWWBWWWWWWWWBWWWWWWWWBWWWWWWWWBWWWBBWWWWWWWWWWWWBBWWBBWWWWWWWWBWWWWWWWBBWWWWWWWWBWWWBBWWWWWWWBWWWWWWWWBBWWWWWWWWWWWWBWWWWWWWWBWWWBWWWWBWWWBB
BBWWWBWWWWWWWWBWWWWWWWWBWWWWWWWWBWWWBBWWWWWWWWWWWWBBWWBBWWWWWWWBBWWWWWWWBBWWWWWWWWBWWWBBWWWWWWWBWWWWWWWWBBWWWWWWWWWWWWBWWWWWWWWBWWWBWWWWBBWWBB
BBWWWBWWWWBWWWBWWWBBBBBBWWWWBBBBBWWWBBBBBBBBBBBWWWBBWWBBBBBBBBBBBWWWBBBBBBWWWBWWWWBWWWBBBBBBWWWBWWWWBWWWBBWWWBBBBBBBBBBWWWBBWWWBWWWBWWWWBBBBBB
BBWWWBWWWWBWWWBWWWWWWWWBWWWWWWWBBWWWBBWWWWWWBBBWWWBBWWBBBWWWWWWWWWWWBBWWWWWWWBWWWWBWWWWWWWBBWWWBWWWWBWWWBBWWWWWWWWWWWBBWWWBBWWWBWWWWWWWWWWWWBB
BBWWWBWWWWBWWWBWWWWWWWWBWWWWWWWWBWWWBBWWWWWWWWBWWWBBWWBBWWWWWWWWWWWWBBWWWWWWWBWWWWBWWWWWWWBBWWWBWWWWBWWWBBWWWWWWWWWWWWBWWWBBWWWBWWWWWWWWWWWWBB
BBWWWBWWWWBWWWBWWWWWWWWBWWWWWWWWBWWWBBWWWWWWWWBWWWBBWWBBWWWWWWWWWWWWBBWWWWWWWBWWWWBWWWWWWWBBWWWBWWWWBWWWBBWWWWWWWWWWWWBWWWBBWWWBWWWWWWWWWWWWBB
BBWWWBWWWWBWWWBBBBBBWWWBBBBBBBBBBWWWBBWWWBBBBBBWWWBBWWBBWWWBWWWWBBBBBBWWWBBBBBWWWWBBBBBWWWBBWWWBWWWWBWWWBBBBBBBBBBWWWWBWWWBBWWWBBBBBBBBBBWWWBB
BBWWWBWWWWBWWWBBBBBBWWWBBBBBBBBBBWWWBBWWWBBBBBBWWWBBWWBBWWWBWWWWBBBBBBWWWBBBBBWWWWBBBBBBWWBBWWWBWWWWBWWWBBBBBBBBBBWWWWBWWWBBWWWBBBBBBBBBBWWWBB
BBWWWWWWWWBWWWBBWWBBWWWWWWWWWWWWWWWWBBWWWWWWWWBWWWBBWWBBWWWBWWWWWWWWBBWWWWWWWBWWWWWWWWBBWWBBWWWWWWWWBWWWWWWWBBWWWBWWWWWWWWBBWWWBWWWWWWWBBWWWBB
BBWWWWWWWWBWWWBWWWBBWWWWWWWWWWWWWWWWBBWWWWWWWWBWWWBBWWBBWWWBWWWWWWWWBBWWWWWWWBWWWWWWWWBBWWBBWWWWWWWWBWWWWWWWWBWWWBWWWWWWWWBBWWWBWWWWWWWWBWWWBB
BBWWWWWWWBBWWWBWWWBBWWWWWWWWWWWWWWWWBBWWWWWWWWBWWWBBWWBBBWWBBWWWWWWWBBWWWWWWWBBWWWWWWWBBWWBBWWWWWWWBBWWWWWWWWBWWWBBWWWWWWWBBWWWBWWWWWWWBBWWWBB
BBBBBBBBBBBWWWBWWWBBBBBBBBBBBBBBBBBBBBBBBBWWWWBWWWBBWWBBBBBBBBBBBWWWBBBBBBWWWBBBBBBWWWBBWWBBBBBBBBBBBBBBBBWWWBWWWBBBBBBBBBBBWWWBWWWBBBBBBWWWBB
BBWWWWWWWBBWWWBWWWWWWWBBBWWBBBWWWWWWWWWWBBWWWWWWWWBBWWBBWWWWWWWWWWWWBBWWWWWWWWWWWBBWWWBBWWWWWWWWWWWWWWWWBBWWWBWWWWWWWBBBWWWWWWWBWWWWWWWWWWWWBB
BBWWWWWWWWBWWWBWWWWWWWWBWWWWBWWWWWWWWWWWWBWWWWWWWWBBWWBBWWWWWWWWWWWWBBWWWWWWWWWWWWBWWWBBWWWWWWWWWWWWWWWWBBWWWBWWWWWWWWBWWWWWWWWBWWWWWWWWWWWWBB
BBWWWWWWWWBWWWBWWWWWWWWBWWWWBWWWWWWWWWWWWBWWWWWWWWBBWWBBWWWWWWWWWWWWBBWWWWWWWWWWWWBWWWBBWWWWWWWWWWWWWWWWBBWWWBWWWWWWWWBWWWWWWWWBWWWWWWWWWWWWBB
BBWWWWWWWWBWWWBBWWWWWWWBWWWWBWWWWWWWWWWWWBBWWWWWWWBBWWBBWWWWWWWWWWWWBBWWWWWWWWWWWWBWWWBBWWWWWWWWWWWWWWWWBBWWWBWWWWWWWWBWWWWWWWBBBWWWWWWWWWWWBB
BBWWWBWWWWBWWWBBBBBBWWWBWWWWBWWWBWWWBBWWWBBBBBBBBBBBWWBBWWWBBBBBBBBBBBWWBBBBBBWWWWBWWWBBWWBBBBBBBBBBBWWWBBWWWBBBBBWWWWBWWWBBBBBBBBBBBBBBBWWWBB
BBWWWBWWWWBWWWWWWWWWWWWBWWWWBWWWBWWWBBWWWWWWWWWWWWBBWWWWWWWBBWWWWWWWBBWWBBWWWWWWWWBWWWBBWWWWWWWBBWWWWWWWBBWWWWWWWBWWWWWWWWBBWWWWWWWBBWWWWWWWBB
BBWWWBWWWWBWWWWWWWWWWWWBWWWWBWWWBWWWBBWWWWWWWWWWWWBBWWWWWWWBWWWWWWWWBBWWBBWWWWWWWWBWWWBBWWWWWWWBWWWWWWWWBBWWWWWWWBWWWWWWWWBBWWWWWWWBWWWWWWWWBB
BBWWWBWWWWBWWWWWWWWWWWWBWWWWBWWWBWWWBBWWWWWWWWWWWWBBWWWWWWWBWWWWWWWWBBWWBBWWWWWWWWBWWWBBWWWWWWWBWWWWWWWWBBWWWWWWWBWWWWWWWWBBWWWWWWWBWWWWWWWWBB
BBWWWBWWWWBBBBBWWWBBBBBBWWWWBWWWBWWWBBBBBBBBBBBWWWBBBBBBBBBBWWWWBWWWBBWWBBWWWBBBBBBWWWBBBBBBWWWBWWWWBBBBBBBBBBWWWBBBBBBBBBBBWWWBWWWBWWWWBBBBBB
BBWWWBWWWWBWWBBWWWWWWWWWWWWWBWWWBWWWWWWWWBBWWWWWWWBBWWWWWWWWWWWWBWWWBBWWBBWWWWWWWBBWWWWWWWWWWWWBWWWWWWWBBBWWWWWWWWWWWWWWWWWWWWWBWWWBWWWWWWWBBB
BBWWWBWWWWBWWWBWWWWWWWWWWWWWBWWWBWWWWWWWWBWWWWWWWWBBWWWWWWWWWWWWBWWWBBWWBBWWWWWWWWBWWWWWWWWWWWWBWWWWWWWWBBWWWWWWWWWWWWWWWWWWWWWBWWWBWWWWWWWWBB
BBWWWBWWWWBWWWBWWWWWWWWWWWWWBWWWBWWWWWWWWBWWWWWWWWBBWWWWWWWWWWWWBWWWBBWWBBWWWWWWWWBWWWWWWWWWWWWBWWWWWWWWBBWWWWWWWWWWWWWWWWWWWWWBWWWBWWWWWWWWBB
BBWWWBWWWWBWWWBWWWWBBBBBBBBBBWWWBBBBBBWWWBWWWWBBBBBBWWWBBBBBBBBBBBBBBBWWBBBBBBBBBBBBBBBBBBBBBBBBBBBBBWWWBBWWWBBBBBBBBBBBBBBBBBBBWWWBBBBBBBBBBB
BBWWWBWWWWBWWWBWWWBBBBBBBBBBBWWWBBBBBBWWWBWWWWBBBBBBWWBBBBBBBBBBBBBBBBWWBBBBBBBBBBBBBBBBBBBBBBBBBBBBBWWWBBWWWBBBBBBBBBBBBBBBBBBBWWWBBBBBBBBBBB
BBWWWBWWWWBWWWBWWWWWWWWWWWWWBWWWBBWWBBWWWBWWWWBWWWWWWWBBWWWWWWWWWWWWWWWWBBWWWWWWWWBWWWWWWWWWWWWWWWWWBWWWBBWWWWWWWWWWWWWWWWBBWWBBWWWWWWWWWWWWBB
BBWWWBWWWWBWWWBWWWWWWWWWWWWWBWWWBWWWBBWWWBWWWWBWWWWWWWBBWWWWWWWWWWWWWWWWBBWWWWWWWWBWWWWWWWWWWWWWWWWWBWWWBBWWWWWWWWWWWWWWWWBBWWWBWWWWWWWWWWWWBB
BBWWWBWWWWBWWWBWWWWWWWWWWWWWBWWWBWWWBBWWWBWWWWBWWWWWWWBBWWWWWWWWWWWWWWWWBBWWWWWWWWBWWWWWWWWWWWWWWWWWBWWWBBWWWWWWWWWWWWWWWWBBWWWBWWWWWWWWWWWWBB
BBWWWBWWWWBWWWBBBBBBBBBBWWWWBWWWBWWWBBWWWBWWWWBWWWBWWWBBWWWBBBBBBBBBBBBBBBWWWBWWWWBWWWBBWWBBBBBBWWWWBWWWBBBBBBBBBBBBBBBWWWBBWWWBBBBBBBBBBWWWBB
BBWWWBWWWWBWWWBBWWWWWWWWWWWWWWWWBWWWWWWWWBWWWWWWWWBWWWBBWWWBBWWWWWWWBBWWWWWWWBWWWWWWWWBBWWBBWWWWWWWWBWWWWWWWWWWWWWWWWBBWWWBBWWWBWWWWWWWWWWWWBB
BBWWWBWWWWBWWWBWWWWWWWWWWWWWWWWWBWWWWWWWWBWWWWWWWWBBWWBBWWWBWWWWWWWWBBWWWWWWWBWWWWWWWWBBWWBBWWWWWWWWBWWWWWWWWWWWWWWWWWBWWWBBWWWBWWWWWWWWWWWWBB
BBWWWBWWWWBWWWBWWWWWWWWWWWWWWWWWBWWWWWWWWBWWWWWWWWBBWWBBWWWBWWWWWWWWBBWWWWWWWBWWWWWWWWBBWWBBWWWWWWWWBWWWWWWWWWWWWWWWWWBWWWBBWWWBWWWWWWWWWWWWBB
BBWWWBWWWWBWWWBWWWWWWWWWWWWWWWWWBBWWWWWWBBWWWWWWWWBBWWBBWWWBWWWWWWWWBBWWWWWWBBBWWWWWWWBBWWBBWWWWWWWBBBWWWWWWWWWWWWWWWWBWWWBBWWWBWWWWWWWWWWWWBB
BBWWWBWWWWBWWWBWWWBBBBBBBBBBBBBBBBBBBBBBBBWWWWBBBBBBWWBBWWWBWWWWBWWWBBWWBBBBBBBBBBBBBBBBBBBBWWWBBBBBBBBBBBBBBBBBBBWWWWBWWWBBWWWBWWWBBBBBBBBBBB
BBWWWBWWWWBWWWWWWWBBWWWWWWWBBWWWWWWWBBWWWWWWWWBWWWWWWWWWWWWBWWWWBWWWBBWWBBWWWWWWWBBWWWWWWWBBWWWWWWWWWWWWBBWWWWWWWBWWWWWWWWBBWWWWWWWBBWWWWWWWBB
BBWWWBWWWWBWWWWWWWBBWWWWWWWWBWWWWWWWBBWWWWWWWWBWWWWWWWWWWWWBWWWWBWWWBBWWBBWWWWWWWWBWWWWWWWBBWWWWWWWWWWWWBBWWWWWWWBWWWWWWWWBBWWWWWWWBWWWWWWWWBB
BBWWWBWWWWBWWWWWWWBBWWWWWWWBBWWWWWWWBBWWWWWWWWBWWWWWWWWWWWWBWWWWBWWWBBWWBBWWWWWWWBBWWWWWWWBBWWWWWWWWWWWWBBWWWWWWWBWWWWWWWWBBWWWWWWWBWWWWWWWWBB
BBBBBBWWWWBBBBBBBBBBWWWBBBBBBWWWBWWWBBWWWBBBBBBWWWBBBBBBBBBBWWWWBWWWBWWWBBWWWBBBBBBWWWBWWWBBBBBBBBBBBWWWBBWWWBWWWBBBBBBBBBBBWWWBBBBBWWWWBWWWBB
BBBBBBWWWWBBBBBBBBBBWWWBBBBBBWWWBWWWBBWWWWBBBBBWWWWBBBBBBBBBWWWWBWWWWWWWBBWWWBBBBBBWWWBBWWBBBBBBBBBBBWWWWWWWWBWWWBBBBBBBBBBWWWWBBBBBWWWWBWWWBB
BBWWWWWWWWWWWWWWWWBBWWWBWWWWWWWWBWWWBBWWWWWWWWBWWWWWWWBBWWWWWWWWBWWWWWWWBBWWWBWWWWWWWWBBWWBBWWWWWWWWBWWWWWWWWBWWWWWWWWWWWWWWWWWBWWWWWWWWBWWWBB
BBWWWWWWWWWWWWWWWWBBWWWBWWWWWWWWBWWWBBWWWWWWWWBWWWWWWWBBWWWWWWWWBWWWWWWWBBWWWBWWWWWWWWBBWWBBWWWWWWWWBWWWWWWWWBWWWWWWWWWWWWWWWWWBWWWWWWWWBWWWBB
BBWWWBBBBBBBBBBWWWBBWWWBWWWWBBBBBWWWBBBBBBWWWWBBBBBBBBBBWWWBBBBBBBBBBBBBBBWWWBWWWWBBBBBBWWWBWWWBBBBBBBBBBBBBBBBBBBBBBBBWWWBWWWWBBBBBBBBBBWWWBB
BBWWWBBBBBBBBBBWWWBBWWWBWWWWBBBBBWWWBBBBBBWWWWBBBBBBBBBBWWWBBBBBBBBBBBBBBBWWWBWWWWBBBBBBWWWBWWWBBBBBBBBBBBBBBBBBBBBBBBBWWWBBWWWBBBBBBBBBBWWWBB
BBWWWBBWWWWWWWBWWWBBWWWWWWWWBWWWWWWWBBWWBBWWWWWWWWWWWWBBWWWBWWWWWWWWBBWWWWWWWBWWWWWWWWBBWWWWWWWBWWWWWWWWWWWWBBWWWWWWWWBWWWBBWWWBWWWWWWWWWWWWBB
BBWWWBWWWWWWWWBWWWBBWWWWWWWWBWWWWWWWBBWWWBWWWWWWWWWWWWBBWWWBWWWWWWWWBBWWWWWWWBWWWWWWWWBBWWWWWWWBWWWWWWWWWWWWWBWWWWWWWWBWWWBBWWWBWWWWWWWWWWWWBB
BBWWWBBWWWWWWWBWWWBBWWWWWWWBBWWWWWWWBBWWWBBWWWWWWWWWWWBBWWWBWWWWWWWWBBWWWWWWWBBWWWWWWBBBWWWWWWWBWWWWWWWWWWWWBBWWWWWWWWBWWWBBWWBBWWWWWWWWWWWWBB
BBWWWBBBBBBWWWBWWWBBWWWBBBBBBWWWBBBBBBWWWBBBBBBBBBBBWWBBWWWBWWWWBWWWBBWWBBBBBBBBBBBBBBBBBBBBWWWBWWWWBBBBBBBBBBWWWBWWWWBWWWBBBBBBWWWBBBBBBWWWBB
BBWWWWWWWBBWWWWWWWBBWWWBBWWWWWWWBBWWWWWWWWWWWBBBWWWWWWBBWWWBWWWWBWWWWWWWBBWWWWWWWWWWWWBBWWWWWWWBWWWWWWWWBBWWWWWWWBWWWWBWWWBBWWWWWWWBBBWWWWWWBB
BBWWWWWWWWBWWWWWWWBBWWWBWWWWWWWWBWWWWWWWWWWWWWBWWWWWWWBBWWWBWWWWBWWWWWWWBBWWWWWWWWWWWWBBWWWWWWWBWWWWWWWWBBWWWWWWWBWWWWBWWWBBWWWWWWWBBWWWWWWWBB
BBWWWWWWWWBWWWWWWWBBWWWBWWWWWWWWBWWWWWWWWWWWWWBWWWWWWWBBWWWBWWWWBWWWWWWWBBWWWWWWWWWWWWBBWWWWWWWBWWWWWWWWBBWWWWWWWBWWWWBWWWBBWWWWWWWBBWWWWWWWBB
BBWWWWWWWWBBWWWWWWBBWWWBWWWWWWWWBBWWWWWWWWWWWWBBWWWWWWBBWWWBWWWWBBWWWWWWBBWWWWWWWWWWWWBBWWWWWWBBBWWWWWWWBBWWWWWWBBWWWWBWWWBBWWWWWWBBBBWWWWWWBB
BBWWWBWWWWBBBBBBBBBBWWWBWWWWBBBBBBBBBBWWWBWWWWBBBBBBBBBBWWWBWWWWBBBBBBBBBBWWWBBBBBBWWWBBWWBBBBBBBBBBBWWWBBWWWBBBBBWWWWBWWWBBWWWBBBBBBBBBBWWWBB
BBWWWBWWWWWWWWWWWWWWWWWBWWWWWWWWWWWWBBWWWBWWWWWWWWBBWWWWWWWBWWWWWWWWWWWWBBWWWWWWWBBWWWWWWWBBWWWWWWWWWWWWBBWWWBWWWWWWWWBWWWBBWWWBWWWWWWWBBWWWBB
BBWWWBWWWWWWWWWWWWWWWWWBWWWWWWWWWWWWBBWWWBWWWWWWWWBBWWWWWWWBWWWWWWWWWWWWBBWWWWWWWWBWWWWWWWBBWWWWWWWWWWWWBBWWWBWWWWWWWWBWWWBBWWWBWWWWWWWWBWWWBB
BBWWWBWWWWWWWWWWWWWWWWWBWWWWWWWWWWWWBBWWWBWWWWWWWWBBWWWWWWWBWWWWWWWWWWWWBBWWWWWWWWBWWWWWWWBBWWWWWWWWWWWWBBWWWBWWWWWWWWBWWWBBWWWBWWWWWWWWBBWWBB
BBWWWBBBBBBBBBBBBBBBBBBBBBBBBBBBBWWWBBWWWBWWWWBWWWBBBBBBWWWBBBBBBWWWBWWWBBBBBBWWWWBBBBBBBBBBWWWBBBBBBBBBBBWWWBWWWBBBBBBWWWBBWWWBWWWBWWWWBBBBBB
BBWWWBBBBBBBBBBBBBBBBBBBBBBBBBBBBWWWBBWWWBWWWWBWWWBBBBBBWWWBBBBBBWWWBBWWWBBBBWWWWWBBBBBBBBBBWWWBBBBBBBBBBWWWWBWWWBBBBBBWWWBWWWWWWWWBWWWWBBBBBB
BBWWWWWWWWBWWWWWWWWWWWWWWWWWWWWWWWWWBBWWWBWWWWBWWWWWWWBBWWWWWWWWBWWWBBWWWWWWWWWWWWBWWWWWWWWWWWWWWWWWWWWWWWWWWBWWWBWWWWBWWWWWWWWWWWWBWWWWWWWWBB
BBWWWWWWWWBWWWWWWWWWWWWWWWWWWWWWWWWWBBWWWBWWWWBWWWWWWWBBWWWWWWWWBWWWBBWWWWWWWWWWWWBWWWWWWWWWWWWWWWWWWWWWWWWWWBWWWBWWWWBWWWWWWWWWWWWBWWWWWWWWBB
BBWWWBWWWWBBBBBBBBBBBBBBBBBBBBBBBBBBBBWWWBBBBBBBBBBWWWBBBBBBWWWWBBBBBBBBBBBBBWWWWWBBBBBBBBBBBBBBBBBBBBBBBBBBBBWWWBWWWWBBBBBBBBBBBBBBBBBBWWWWBB
BBWWWBWWWWBBBBBBBBBBBBBBBBBBBBBBBBBBBBWWWBBBBBBBBBBBWWBBBBBBWWWWBBBBBBBBBBBBBBWWWWBBBBBBBBBBBBBBBBBBBBBBBBBBBBWWWBWWWWBBBBBBBBBBBBBBBBBBBWWWBB
BBWWWBWWWWBWWWWWWWBBWWWWWWWWBWWWWWWWBBWWWWWWWWWWWWBBWWWWWWWBWWWWWWWWWWWWWWWWWWWWWWWWWWBBWWWWWWWBWWWWWWWWWWWWBBWWWBWWWWWWWWWWWWWWWWWWWWWWWWWWBB
BBWWWBWWWWBWWWWWWWBBWWWWWWWWBWWWWWWWBBWWWWWWWWWWWWBBWWWWWWWBWWWWWWWWWWWWWWWWWWWWWWWWWWBBWWWWWWWBWWWWWWWWWWWWWBWWWBWWWWWWWWWWWWWWWWWWWWWWWWWWBB
BBWWWBWWWWBWWWWWWWBBWWWWWWWWBWWWWWWWBBWWWWWWWWWWWWBBWWWWWWWBBWWWWWWWWWWWWWWWWWWWWWWWWWBBWWWWWWWBBWWWWWWWWWWWWBWWWBWWWWWWWWWWWWWWWWWWWWWWWWWWBB
BBWWWBWWWWBWWWBWWWBBWWWBWWWWBWWWBWWWBBBBBBBBBBBWWWBBBBBBWWWBBBBBBBBBBBBBBBBBBBBBBBBWWWBBWWWBWWWBBBBBBWWWBBWWWBWWWBWWWWBBBBBBBBBBBBBBBBBBBWWWBB
BBWWWBWWWWWWWWBWWWWWWWWBWWWWBWWWBWWWWWWWBBBWWWWWWWBBWWWWWWWWWWWWWWWWWWWWWWWWBBBBBBBWWWBBWWBBWWWBBWWWWWWWBBWWWWWWWBWWWWBBWWWWWWBBBWWWWWWWWWWWBB
BBWWWBWWWWWWWWBWWWWWWWWBWWWWBWWWBWWWWWWWWBWWWWWWWWBBWWWWWWWWWWWWWWWWWWWWWWWWWBBWWBBWWWBBWWBBWWWBWWWWWWWWBBWWWWWWWBWWWWBWWWWWWWWBWWWWWWWWWWWWBB
BBWWWBWWWWWWWWBWWWWWWWWBWWWWBWWWBWWWWWWWWBWWWWWWWWBBWWWWWWWWWWWWWWWWWWWWWWWWWBWWWWBWWWBBWWBBWWWBWWWWWWWWBBWWWWWWWBWWWWBWWWWWWWWBWWWWWWWWWWWWBB
BBWWWBBWWWWWWWBBWWWWWWBBWWWWBWWWBBWWWWWWWBWWWWWWWWBBWWWWWWWWWWWWWWWWWWWWWWWWWBWWWWBWWWBBWWBBWWWBWWWWWWWWBBWWWWWWBBBWWBBWWWWWWWWBWWWWWWWWWWWWBB
BBWWWBBBBBBBBBBBBBBBBBBBWWWWBWWWBBBBBBWWWBWWWWBBBBBBWWBBBBBBBBBBBWWWBBBBBBWWWBWWWWBWWWBBBBBBWWWBWWWWBBBBBBWWWBBBBBBBBBBWWWBBWWWBWWWBBBBBBBBBBB
BBWWWWWWWWWWWWBWWWWWWWWWWWWWBWWWBWWWWWWWWBWWWWWWWBBBWWWWWWWBBWWWWWWWBBWWWWWWWWWWWWBWWWWWWWWWWWWBWWWWBWWWWWWWWBBWWBBWWWWWWWBBWWWBWWWWWWWWWWWWBB
BBWWWWWWWWWWWWBWWWWWWWWWWWWWBWWWBWWWWWWWWBWWWWWWWWBBWWWWWWWBWWWWWWWWBBWWWWWWWWWWWWBWWWWWWWWWWWWBWWWWBWWWWWWWWBWWWBWWWWWWWWBBWWWBWWWWWWWWWWWWBB
BBWWWWWWWWWWWWBWWWWWWWWWWWWWBWWWBWWWWWWWWBWWWWWWWWBBWWWWWWBBWWWWWWWWBBWWWWWWWWWWWWBWWWWWWWWWWWWBWWWWBWWWWWWWBBWWWBWWWWWWWWBBWWWBWWWWWWWWWWWWBB
BBBBBBBBBBBWWWBWWWBBBBBBBBBBBWWWBWWWBBBBBBBBBBBBBBBBWWBBBBBBWWWWBBBBBBWWBBBBBBBBBBBBBBBBBBBBWWWBWWWWBWWWBBBBBBWWWBWWWWBBBBBBWWWBWWWBBBBBBBBBBB
BBBBBBBBBBWWWWBWWWWBBBBBBBBBBWWWBWWWWBBBBBBBBBBBBBBBWWBBBBBBWWWWBBBBBBWWBBBBBBBBBBBBBBBBBBBBWWWBWWWWBWWWWBBBBBWWWBWWWWBBBBBWWWWBWWWBBBBBBBBBBB
BBWWWWWWWWWWWWBWWWWWWWWWWWWWBWWWBWWWWWWWWWWWWWWWWWBBWWBBWWWWWWWWWWWWBBWWBBWWWWWWWWWWWWWWWWBBWWWBWWWWBWWWWWWWBBWWWWWWWWBWWWWWWWWBWWWBWWWWWWWWBB
BBWWWWWWWWWWWWBWWWWWWWWWWWWWBWWWBWWWWWWWWWWWWWWWWWBBWWBBWWWWWWWWWWWWBBWWBBWWWWWWWWWWWWWWWWBBWWWBWWWWBWWWWWWWBBWWWWWWWWBWWWWWWWWBWWWBWWWWWWWWBB
BBWWWBBBBBBBBBBBBBBBWWWBWWWWBWWWBBBBBBBBBBBBBBBWWWBBBBBBWWWBBBBWWWWWBBWWBBBBBBBBBBBBBBBWWWBBWWWBWWWWBBBBBBBBBBWWWBBBBBBWWWBBBBBBWWWBWWWWBWWWBB
BBWWWBBBBBBBBBBBBBBBWWWBWWWWBWWWBBBBBBBBBBBBBBBWWWBBBBBBWWWBBBBBBWWWBBWWBBBBBBBBBBBBBBBBWWBBWWWBWWWWBBBBBBBBBBWWWBBBBBBWWWBBBBBBWWWBWWWWBWWWBB
BBWWWBWWWWWWWWWWWWBBWWWBWWWWBWWWWWWWWWWWWBWWWWWWWWBBWWWWWWWBBWWWWWWWBBWWWWWWWWWWWWWWWWWWWWBBWWWBWWWWWWWWWWWWWWWWWBBWWBBWWWBBWWWWWWWBWWWWBWWWBB
BBWWWBWWWWWWWWWWWWBBWWWBWWWWBWWWWWWWWWWWWBWWWWWWWWBBWWWWWWWBWWWWWWWWBBWWWWWWWWWWWWWWWWWWWWBBWWWBWWWWWWWWWWWWWWWWWBWWWWBWWWBBWWWWWWWBWWWWBWWWBB
BBWWWBWWWWWWWWWWWWBBWWWBWWWWBWWWWWWWWWWWWBWWWWWWWWBBWWWWWWWBBWWWWWWWBBWWWWWWWWWWWWWWWWWWWWBBWWWBBWWWWWWWWWWWWWWWWBWWWWBWWWBBWWWWWWWBWWWWBWWWBB
BBBBBBWWWWBWWWBWWWBBBBBBWWWWBBBBBBBBBBWWWBWWWWBBBBBBWWBBBBBBBBBBBBBBBBWWBBBBBBBBBBBBBBBBBBBBWWWBBBBBBBBBBBWWWBWWWBWWWWBWWWBBWWWBWWWBWWWWBWWWBB
BBWWWWWWWWBWWWBWWWWWWWWWWWWWBBWWWWWWBBWWWBWWWWWWWWBBWWWWWWWWWWWBBBWWWWWWBBWWWWWWWBBBWWWWWWBBWWWWWWWBBBWWWWWWWBWWWBWWWWWWWWBBWWWBWWWWWWWWBWWWBB
BBWWWWWWWWBWWWBWWWWWWWWWWWWWBWWWWWWWBBWWWBWWWWWWWWBBWWWWWWWWWWWWBWWWWWWWBBWWWWWWWWBWWWWWWWBBWWWWWWWWBWWWWWWWWBWWWBWWWWWWWWBBWWWBWWWWWWWWBWWWBB
BBWWWWWWWWBWWWBWWWWWWWWWWWWWBWWWWWWWBBWWWBWWWWWWWWBBWWWWWWWWWWWWBWWWWWWWBBWWWWWWWWBWWWWWWWBBWWWWWWWWBWWWWWWWWBWWWBWWWWWWWWBBWWWBWWWWWWWWBWWWBB
BBWWWWWWWWBBWBBBWWWWWWWWWWWBBWWWWWWWBBWWWBBWWWWWWWBBWWWWWWWWWWWWBWWWWWWWBBWWWWWWWWBWWWWWWWBBWWWWWWWWBBWWWWWWBBBWBBBWWWWWWWBBWWBBWWWWWWWBBBWWBB
BBWWWBWWWWBBBBBBBBBBBBBBBBBBBWWWBWWWBBWWWBBBBBBWWWBBBBBBBBBBWWWWBWWWBBBBBBWWWBWWWWBWWWBBWWBBBBBBWWWWBBBBBBBBBBBBBBBBBBBWWWBBBBBBBBBBBBBBBBBBBB
BBWWWBWWWWWWWWBWWWWWWWWWWWWWWWWWBWWWWWWWWBBWWWWWWWBBWWWWWWWBWWWWBWWWBBWWWWWWWBWWWWWWWWBBWWBBBWWBWWWWWWWWBBWWWWWWWWWWWBBWWWWWWWWWWWWWWWWWWWWWBB
BBWWWBWWWWWWWWBWWWWWWWWWWWWWWWWWBWWWWWWWWBWWWWWWWWBBWWWWWWWBWWWWBWWWBBWWWWWWWBWWWWWWWWBBWWBBWWWBWWWWWWWWBBWWWWWWWWWWWWBWWWWWWWWWWWWWWWWWWWWWBB
BBWWWBWWWWWWWWBWWWWWWWWWWWWWWWWWBBWWWWWWWBWWWWWWWWBBWWWWWWWBWWWWBWWWBBWWWWWWWBWWWWWWWWBBWWBBWWWBWWWWWWWWBBWWWWWWWWWWWWBWWWWWWWWWWWWWWWWWWWWWBB
BBWWWBBBBBBWWWBWWWBBBBBBBBBBBBBBBBBBBBBBBBWWWWBBBBBBWWWBWWWBWWWWBWWWBBBBBBWWWBWWWWBBBBBBWWWBWWWBBBBBBWWWBBWWWBWWWBWWWWBBBBBBBBBBBBBBBBBBBWWWBB
BBWWWBBBBBBWWWBWWWBBBBBBBBBBBBBBBBBBBBBBBBWWWWBBBBBWWWBBWWWBWWWWBWWWBBBBBWWWWBWWWWBBBBBBWWWBWWWBBBBBBWWWBBWWWBWWWBWWWWBBBBBBBBBBBBBBBBBBBWWWBB
BBWWWBWWWWBWWWWWWWBBWWWWWWWWWWWWBWWWWWWWWBWWWWWWWWWWWWBBWWWWWWWWBWWWWWWWWWWWWBWWWWWWWWBBWWWWWWWBWWWWWWWWBBWWWBWWWBWWWWWWWWWWWWWBWWWBWWWWWWWWBB
BBWWWBWWWWBWWWWWWWBBWWWWWWWWWWWWBWWWWWWWWBWWWWWWWWWWWWBBWWWWWWWWBWWWWWWWWWWWWBWWWWWWWWBBWWWWWWWBWWWWWWWWBBWWWBWWWBWWWWWWWWWWWWWBWWWBWWWWWWWWBB
BBWWWBWWWWBWWWWWWWBBWWWWWWWWWWWWBWWWWWWWWBBWWWWWWWWWWWBBBWWWWWWBBWWWWWWWWWWWWBBWWWWWWBBBWWWWWWWBWWWWWWWWBBWWWBWWWBBWWWWWWWWWWWWBWWWBWWWWWWWBBB
BBWWWBWWWWBBBBBBBBBBWWWBBBBBBWWWBWWWBBWWWBBBBBBWWWBBBBBBBBBBBBBBBBBBBBBBBBBBBBBBBBBBBBBBWWBBBBBBWWWWBWWWBWWWWBWWWBBBBBBBBBBBWWWBWWWBWWWWBBBBBB
BBWWWBWWWWWWWWWWWWBBWWWWWWWWBWWWBWWWBBWWWWWWWWBWWWWWWWBBWWWWWWWWWWWWBBWWWWWWWWWWWWBWWWWWWWBBWWWWWWWWBWWWWWWWWBWWWBWWWWWWWWBBWWWWWWWBWWWWWWWWBB
BBWWWBWWWWWWWWWWWWBBWWWWWWWWBWWWBWWWBBWWWWWWWWBWWWWWWWBBWWWWWWWWWWWWBBWWWWWWWWWWWWBWWWWWWWBBWWWWWWWWBWWWWWWWWBWWWBWWWWWWWWBBWWWWWWWBWWWWWWWWBB
BBWWWBBWWWWWWWWWWWBBWWWWWWWWBWWWBWWWBBWWWWWWWWBWWWWWWWBBWWWWWWWWWWWWBBWWWWWWWWWWWWBWWWWWWWBBWWWWWWWBBWWWWWWWWBBWWBWWWWWWWWBBWWWWWWWBBWWWWWWWBB
BBWWWBBBBBBBBBBWWWBBBBBBWWWWBWWWBWWWBBBBBBWWWWBBBBBBWWBBWWWBBBBBBWWWBBBBBBBBBBWWWWBWWWBBBBBBWWWBBBBBBBBBBBBBBBBBBBWWWWBBBBBBWWWBBBBBBBBBBWWWBB
BBWWWWWWWBBBWBBWWWBBWWWWWWWWBWWWBWWWWWWWBBWWWWWWWBBBWWBBWWWWWWWBBWWWWWWWWWWWBBWWWWWWWWBBWWWWWWWWWWWWWWWBBBWWWWWWBBWWWWWWWWBBWWWBBWWWWWWBBWWWBB
BBWWWWWWWWBWWWBWWWBBWWWWWWWWBWWWBWWWWWWWWBWWWWWWWWBBWWBBWWWWWWWWBWWWWWWWWWWWWBWWWWWWWWBBWWWWWWWWWWWWWWWWBBWWWWWWWBWWWWWWWWBBWWWBWWWWWWWWBWWWBB
BBWWWWWWWWBWWWBWWWBBWWWWWWWWBWWWBWWWWWWWWBWWWWWWWWBBWWBBWWWWWWWWBWWWWWWWWWWWWBWWWWWWWWBBWWWWWWWWWWWWWWWWBBWWWWWWWBWWWWWWWWBBWWWBWWWWWWWWBWWWBB
BBWWWWWWWWBWWWBWWWBBWWWWWWWBBWWWBBWWWWWWWBBWWWWWWBBBWWBBWWWWWWWWBBWWWWWWWWWWWBBWWWWWWWBBWWWWWWWWWWWWWWWWBBWWWWWWWBBWWWWWWWBBWWWBWWWWWWWWBWWWBB
BBWWWBWWWWBWWWBWWWBBWWWBBBBBBWWWBBBBBBWWWBBBBBBBBBBBWWBBBBBBWWWWBBBBBBWWWBWWWBBBBBBBBBBBWWBBBBBBBBBBBBBBBBWWWBWWWBBBBBBWWWBBWWWBWWWBWWWWBWWWBB
BBWWWBWWWWWWWWBWWWWWWWWBBWWBBWWWWWWWBBWWWWWWWWWWWWBBWWWWWWWBWWWWBWWWWWWWBBWWWBBWWWWWWWWWWWWWWWWBBWWWWWWWWWWWWBWWWBBWWWWWWWBBWWWWWWWBWWWWWWWWBB
BBWWWBWWWWWWWWBWWWWWWWWBWWWWBWWWWWWWBBWWWWWWWWWWWWBBWWWWWWWBWWWWBWWWWWWWBBWWWBWWWWWWWWWWWWWWWWWBWWWWWWWWWWWWWBWWWBWWWWWWWWBBWWWWWWWBWWWWWWWWBB
BBWWBBWWWWWWWWBWWWWWWWWBWWWWBWWWWWWWBBWWWWWWWWWWWWBBWWWWWWWBWWWWBWWWWWWWBBWWWBWWWWWWWWWWWWWWWWWBWWWWWWWWWWWWBBWWWBWWWWWWWWBBWWWWWWWBWWWWWWWWBB
BBBBBBBBBBBWWWBBBBBBBBBBWWWWBWWWBWWWBBBBBBBBBBBWWWBBWWBBBBBBWWWWBWWWBBBBBBBBBBWWWWBBBBBBBBBBBBBBWWWWBWWWBBBBBBWWWBWWWWBWWWBBBBBBBBBBBBBBBBBBBB
BBBBBBBBBBBWWWBBBBBBBBBBWWWWBWWWBWWWBBBBBBBBBBBWWWBBWWBBBBBBWWWWBWWWBBBBBBBBBBWWWWBBBBBBBBBBBBBBWWWWBWWWWBBBBBWWWBWWWWBWWWBBBBBBBBBBBBBBBBBBBB
BBWWWWWWWWWWWWWWWWWWWWWWWWWWBWWWBWWWWWWWWBWWWWWWWWBBWWBBWWWWWWWWBWWWBBWWWWWWWWWWWWBWWWWWWWWWWWWWWWWWBWWWWWWWBBWWWWWWWWBWWWBBWWBBWWWWWWWWWWWWBB
BBWWWWWWWWWWWWWWWWWWWWWWWWWWBWWWBWWWWWWWWBWWWWWWWWBBWWBBWWWWWWWWBWWWBBWWWWWWWWWWWWBWWWWWWWWWWWWWWWWWBWWWWWWWBBWWWWWWWWBWWWBBWWWBWWWWWWWWWWWWBB
BBWWWWWWWWWWWWWWWWWWWWWWWWWBBWWWBBWWWWWWWBWWWWWWWBBBWWBBWWWWWWWBBWWWBBWWWWWWWWWWWBBWWWWWWWWWWWWWWWWBBWWWWWWBBBBWWWWWWBBWWWBBWWWBWWWWWWWWWWWWBB
BBWWWBBBBBBBBBBBBBBBBBBBBBBBBWWWBBBBBBWWWBWWWWBBBBBBWWWBWWWBBBBBBWWWBBWWBBBBBBBBBBBWWWBBBBBBBBBBBBBBBBBBBBBBBBBBBBBBBBBWWWBBWWWBWWWBBBBBBWWWBB
BBWWWWWWWWWWWWBBWWWWWWWBBWWWWWWWWWWWBBWWWWWWWWBWWWWWWWWWWWWBBWWWWWWWBBWWWWWWWWWWWWWWWWBBWWWWWWWWWWWWWWWWWWWWBBWWWWWWWWWWWWBBWWWWWWWBBWWWWWWWBB
BBWWWWWWWWWWWWBWWWWWWWWBWWWWWWWWWWWWBBWWWWWWWWBWWWWWWWWWWWWBWWWWWWWWBBWWWWWWWWWWWWWWWWBBWWWWWWWWWWWWWWWWWWWWWBWWWWWWWWWWWWBBWWWWWWWBWWWWWWWWBB
BBWWWWWWWWWWWWBWWWWWWWWBBWWWWWWWWWWWBBWWWWWWWWBWWWWWWWWWWWWBBWWWWWWWBBWWWWWWWWWWWWWWWWBBWWWWWWWWWWWWWWWWWWWWWBWWWWWWWWWWWWBBWWWWWWWBWWWWWWWWBB
BBBBBBBBBBBWWWBWWWBBWWWBBBBBBWWWBWWWBBBBBBWWWWBWWWBBBBBBBBBBBBBBBBBBBBBBBBBBBBWWWWBBBBBBBBBBWWWBBBBBBBBBBBWWWBWWWBWWWWBBBBBBBBBBBBBBWWWWBWWWBB
BBWWWWWWBBBWWWWWWWBBWWWBBWWWWWWWBWWWBBBWBBWWWWBWWWBBWWWWWWWWWWWWWWWWBBWWWWWWBBWWWWWWWWWWWWBBWWWBBBWWWWWWBBWWWWWWWBWWWWBBWWWWWWWWWWBBWWWWBWWWBB
BBWWWWWWWBBWWWWWWWBBWWWBWWWWWWWWBWWWBBWWWBWWWWBWWWBBWWWWWWWWWWWWWWWWBBWWWWWWWBWWWWWWWWWWWWBBWWWBBWWWWWWWBBWWWWWWWBWWWWBWWWWWWWWWWWWBWWWWBWWWBB
BBWWWWWWWBBWWWWWWWBBWWWBWWWWWWWWBWWWBBWWWBWWWWBWWWBBWWWWWWWWWWWWWWWWBBWWWWWWWBWWWWWWWWWWWWBBWWWBWWWWWWWWBBWWWWWWWBBWWWBWWWWWWWWWWWWBWWWWBWWWBB
BBWWWWWWBBBBWWWWWWBBWWWBWWWWWWWWBWWWBBWWWBWWWWBWWWBBWWWWWWWWWWWWWWWWBBWWWWWWWBBWWWWWWWWWWWBBWWWBBWWWWWWWBBWWWWWWBBBBWBBWWWWWWWWWWWWBWWWWBWWWBB
BBWWWBBBBBBBBBBBBBBBWWWBWWWWBBBBBWWWBBWWWBWWWWBWWWBWWWBBBBBBWWWWBWWWBWWWWBWWWBBBBBBBBBBBWWBBWWWBBBBBBWWWBBWWWBBBBBBBBBBWWWBBBBBBWWWBWWWWBWWWBB
BBWWWWWWWWWWWWWWWWWWWWWWWWWWBWWWWWWWBBWWWWWWWWBWWWWWWWBBBWWWWWWWBWWWWWWWBBWWWWWWWWWWWWWWWWBBWWWWWWWWWWWWBBWWWWWWWWWWWWWWWWBBWWWWWWWWWWWWBWWWBB
BBWWWWWWWWWWWWWWWWWWWWWWWWWWBWWWWWWWBBWWWWWWWWBWWWWWWWBBWWWWWWWWBWWWWWWWBBWWWWWWWWWWWWWWWWBBWWWWWWWWWWWWBBWWWWWWWWWWWWWWWWBBWWWWWWWWWWWWBWWWBB
BBWWWWWWWWWWWWWWWWWWWWWWWWWWBWWWWWWWBBWWWWWWWWBWWWWWWWBBWWWWWWWWBWWWWWWWBBWWWWWWWWWWWWWWWWBBWWWWWWWWWWWWBBWWWWWWWWWWWWWWWWBBWWWWWWWWWWWWBWWWBB
BBBBBBBBBBBBBBBBBBBBBBBBBBBBBBBBBBBBBBBBBBBBBBBBBBBBBBBBBBBBBBBBBBBBBBBBBBBBBBBBBBBBBBBBBBBBBBBBBBBBBBBBBBBBBBBBBBBBBBBBBBBBBBBBBBBBBBBBBWWWBB
BBBBBBBBBBBBBBBBBBBBBBBBBBBBBBBBBBBBBBBBBBBBBBBBBBBBBBBBBBBBBBBBBBBBBBBBBBBBBBBBBBBBBBBBBBBBBBBBBBBBBBBBBBBBBBBBBBBBBBBBBBBBBBBBBBBBBBBBBWWWBB
